        #########
        #   #####
        # # ##  #
        #     B #
######### ###   #
#.     ## B   ###
#.          B ###
#.     ##     &##
#########     ###
        #      ##
        ### ## ##
        ###    ##
        #########