#################
#########   #####
######### # ##  #
#########     B #
######### ###   #
#.     ## B   ###
#.          B ###
#.     ##     &##
#########     ###
#########      ##
########### ## ##
###########    ##
#################