        ######## 
        #     &# 
        #  #B ## 
        # B   #  
        ##    #  
######### B # ###
#..    ##   B   #
##              #
#..    ##########
########          