           ########
           #     .#
############      #
#    #  B        .#
# B  #     #      #
#          #     .#
#    #     ########
#    #     #
## #########
#    #    ##
#     B   ##
#    #    &#
#    #    ##
###########