##########
##&   ####
## BB  ###
## #. .###
##     ###
##########