############
#.   #     ###
#    #    B  #
#    # ####  #
#      & ##  #
#.   # #  B ##
###### ##    #
  #          #
  #    #     #
  ############