######  ### 
#.   # ##&##
#.   ###   #
#       BB #
#.   # #   #
#. ### # B #
####   #   #
   #   # B #
   #       #
   #  ##   #
   #########
